2 2 2 2 2 1 1 1 1 3 3 3 3 1 1 1 1 1 1 1 1 1 1 1 1
1 1 1 1 2 2 2 2 2 2 2 2 2 2 3 3 1 1 1 1 1 1 1 1 1
1 1 1 1 1 1 1 1 1 1 1 1 1 2 3 3 1 1 1 1 1 1 1 1 1
3 3 3 3 3 3 3 3 13 13 3 3 3 2 3 3 3 3 3 3 3 3 3 3 3  
3 3 3 3 3 3 3 3 13 13 3 3 3 2 3 3 3 3 3 3 3 3 3 3 3 
3 3 3 3 3 3 3 3 13 13 3 3 3 2 3 3 3 3 3 3 3 3 3 3 3
3 3 1 1 3 3 3 3 3 1 3 3 1 2 3 3 36 37 3 3 3 3 3 3 3
3 3 1 2 2 2 2 2 2 2 2 2 2 2 3 3 34 35 3 3 3 3 3 3 3
3 3 1 2 3 3 3 3 3 3 3 3 3 3 3 3 3 3 3 3 3 3 3 3 3
3 3 3 2 3 3 3 3 3 3 3 3 3 3 3 3 3 35 34 3 3 3 3 3 3
3 3 3 2 3 3 3 3 3 3 3 3 3 3 3 3 3 37 36 3 3 3 3 3 3
3 3 1 2 3 1 3 3 3 3 3 3 3 3 3 3 3 3 3 3 3 3 3 3 3
3 3 1 2 1 3 3 3 3 3 3 3 3 3 3 3 3 3 3 3 3 1 1 1 1
3 3 1 2 3 3 3 3 3 3 3 3 3 3 3 3 3 1 1 3 3 1 3 3 3
3 3 1 2 2 2 2 2 2 2 2 2 2 2 2 2 2 2 2 2 2 2 2 2 2
3 3 3 3 3 3 1 3 1 3 3 1 1 3 3 3 3 3 1 3 3 3 3 3 1
3 3 3 3 3 3 3 3 3 3 3 3 3 3 3 3 3 3 3 3 3 3 3 3 3
3 3 3 3 3 3 3 3 3 3 3 3 3 3 3 3 3 3 3 3 3 3 3 3 3
3 3 3 3 3 3 3 3 3 3 3 3 3 3 3 3 3 3 3 3 3 3 3 3 3
3 3 3 3 3 3 3 3 3 3 3 3 3 3 3 3 3 3 3 3 3 3 3 3 3
39 39 39 39 39 39 39 39 39 39 39 39 39 39 39 39 39 39 39 39 39 39 39 39 39
39 39 39 39 39 39 39 39 39 39 39 39 39 39 39 39 39 39 39 39 39 39 39 39 39